NO ./textures/Brick1.xpm
SO ./textures/Brick1.xpm
WE ./textures/Brick1.xpm
EA ./textures/Brick1.xpm
F 220,100,0
C 225,30,0



111 1111
101 1001
101N1101
10000001
11111111
