NO ./textures/Brick1.xpm
SO ./textures/Brick1.xpm
WE ./textures/Brick1.xpm
EA ./textures/Brick1.xpm
F 220,100,0
C 225,30,0
111111111 1111111111111111111111111111111111
100000001 1000000000000000000000000000000001
10000000111000001110000011000000000000000001
10000000000000001 10000111101111111111111111
100011110000000011100001  101
10001  10000010000000001  101 11111111111111
1000111100001 10000000W111101110110000000001
10000000000001000000000011000000110101010101
10000000000000000000000000000000000111111111
10000001110111111110000000000000010101010101
10000001 10000000010000000000000010000000001
10000001 11111111010000000000111111111111111
10000001 100000000100000000001
11111111 111111111111111111111
