F 220,100,0

EA ./textures/Brick1.xpm

NO ./textures/Brick1.xpm



C 225,30,0
   
  

SO ./textures/Brick1.xpm

WE ./textures/Brick1.xpm




111111111 1111111111111111111111111111111111
100000001 1000000000000000000000000000000001
10011000111000001110000011000000000000000001
10000000000001001 10000111101111111111111111
100011110000000011100001  101
10001  10000010000000001  101 11111111111111
10001111000011100010000111101110110000000001
10000000000001000111000011000000110101010101
10111100000000000000000000001000000111111111
100000011101111111100000001000100101010101011111111
10011001 100000000100001000000000100000000000000001
10011001 111111110100000001001111111111111111111101
10000001 100000000100000000001                  101
11111111 111111111111111111101     1111111111111101
                           101     1000000000000001
            11111111       101     1011111111111111
            10000001       101     101
            10111101       101     101
            101  101       101     101
            101  1011111111101     101
            101  1000000000001     101
            101  1011111111101     101
            101  101       101     101
            10111101       101     101
            10000001       101     101
            11111111       101     101
                           10111111101
                           10000000001
                           11111N11111
                               111
